###################################################################################################
###################################################################################################
###################################################################################################
###################################################################################################
###################################################################################################
###################################################################################################
###################################################################################################
###################################################################################################
###################################################################################################
###################################################################################################
###################################################################################################
###################################################################################################
###################################################################################################
###################################################################################################
###################################################################################################
###################################################################################################
#################..................................................................################
#################..................................................................################
#################..................................................................################
#################..................................................................################
#################..................................................................################
#################..................................................................################
#################..................................................................################
#################..................................................................################
#################..................................................................################
#################..................................................................################
#################..................................................................################
#################..................................................................################
#################..................................................................################
#################..................................................................################
#################..................................................................################
#################..................................................................################
#################..................................................................################
#################..................................................................################
#################..................................................................################
#################..................................................................################
#################..................................................................################
#################..................................................................################
#################..................................................................################
#################..................................................................################
#################..................................................................################
#################..................................................................################
#################..................................................................################
#################..................................................................################
#################..................................................................################
#################..................................................................################
#################..................................................................################
#################..................................................................################
#################..................................................................################
#################..................................................................################
#################..................................................................################
#################..................................................................################
#################..................................................................################
#################..................................................................################
#################..................................................................################
#################..................................................................################
#################..................................................................################
#################..................................................................################
#################..................................................................################
#################..................................................................################
#################..................................................................################
#################..................................................................################
#################..................................................................################
#################..................................................................################
#################..................................................................################
#################..................................................................################
#################..................................................................################
#################..................................................................################
#################..................................................................################
#################..................................................................################
#################..................................................................################
#################..................................................................################
#################..................................................................################
#################..................................................................################
#################..................................................................################
#################..................................................................################
#################..................................................................################
#################..................................................................################
#################..................................................................################
#################..................................................................################
#################..................................................................################
#################..................................................................################
#################..................................................................################
###################################################################################################
###################################################################################################
###################################################################################################
###################################################################################################
###################################################################################################
###################################################################################################
###################################################################################################
###################################################################################################
###################################################################################################
###################################################################################################
###################################################################################################
###################################################################################################
###################################################################################################
###################################################################################################
###################################################################################################
###################################################################################################